

C 81,209,246
F 66,70,050

SO tex/Wall2.png
NO tex/Wall1.png
WE tex/Wall3.png
EA tex/Wall4.png

 11111111111111 
1000000000000001
1000000000000001
1000000000000001
1000000000000001
1000000000000001
10000001000000011111
100000101000000000001
10000001000000011111
1000000000000001
1000000000N00001
1000000000000001
1000000000000001
1000000000000001   
1000000000000001   
 11111111111111