11111111111
100000001E1
10P00C00111
10000000001
11111111111