1111111111111
100P00C00E001
1111111111111