1111111111111
1000000000001
100P00C00E001
1000000000001
1111111111111