11111111111
100P00C00E1
11111111111