11111111111111111111111111111111111111
10P0000000000C000000000000000000000E01
11111111111111111111111111111111111111