111111111111
100000010001
10P00C010E01
100000010001
111111111111