111111111
1000001E1
10P0C0111
100000001
111111111