1111111111111
1P100000000C1
10100C0000001
101000000E001
1011111111001
10000000000C1
1111111111111